impulsive_venture_survey_14	Would you like to learn to fly an aeroplane?
bis11_survey_20	I act on the spur of the moment.
future_time_perspective_survey_7	I could do anything I want in the future.
theories_of_willpower_survey_12	Resisting temptations activates your willpower and you become even better able to face new upcoming temptations.
impulsive_venture_survey_13	Do you usually think carefully before doing anything?
mpq_control_survey_12	I am not as cautious.
time_perspective_survey_3	Familiar childhood sights, sounds, smells often bring back a flood of wonderful memories.
mpq_control_survey_20	I organize my work.
dospert_rp_survey_6	Drinking heavily at a social function.
dospert_rt_survey_6	Drinking heavily at a social function.
future_time_perspective_survey_6	My future seems infinite to me.
dospert_rp_survey_23	Speaking your mind about an unpopular issue in a meeting at work.
time_perspective_survey_53	Spending what I earn on pleasures today is better than saving for tomorrow's security.
mindful_attention_awareness_survey_4	I find it difficult to stay focused on whats happening in the present.
ten_item_personality_survey_7	Open to new experiences, complex.
dospert_rt_survey_29	Starting a new career in your mid-thirties.
mindful_attention_awareness_survey_2	I could be experiencing some emotion and not be conscious of it until some time later.
time_perspective_survey_36	It takes joy out of the process and flow of my activities, if I have to think about goals, outcomes, and products.
dospert_rp_survey_14	Going whitewater rafting at high water in the spring.
impulsive_venture_survey_29	Do you usually work quickly, without bothering to check?
dospert_rp_survey_22	Choosing a career that you truly enjoy over a more secure one.
upps_impulsivity_survey_20	Once I get going on something I hate to stop.
time_perspective_survey_33	It is more important for me to enjoy life's journey than to focus only on the destination.
upps_impulsivity_survey_22	I don't like to start a project until I know exactly how to proceed.
time_perspective_survey_9	I do things impulsively.
dospert_rp_survey_7	Taking some questionable deductions on your income tax return.
theories_of_willpower_survey_10	If you have just resisted a strong temptation, you feel strengthened and you can withstand any new temptations.
dickman_survey_6	I am good at taking advantage of unexpected opportunities,where you have to do something immediately or lose your chance.
time_perspective_survey_29	I feel that it's more important to enjoy what you're doing than to get work done on time.
bis11_survey_13	I am a careful thinker.
dospert_eb_survey_30	Leaving your young children alone at home while running an errand.
time_perspective_survey_37	Even when I am enjoying the present, I am drawn back to comparisons with similar past experiences.
upps_impulsivity_survey_56	Before making up my mind, I consider all the advantages and disadvantages.
dospert_rp_survey_19	Investing 10% of your annual income in a new business venture.
mpq_control_survey_5	I stop and think.
future_time_perspective_survey_4	My future is filled with possibilities.
self_regulation_survey_19	I have trouble making plans to help me reach my goals.
upps_impulsivity_survey_5	I generally like to see things through to the end.
bis11_survey_9	I am self controlled.
dospert_rp_survey_24	Sunbathing without sunscreen.
eating_survey_13	I do not eat some foods because they make me fat.
mpq_control_survey_9	I value rational approach.
mpq_control_survey_4	I think before doing.
mindful_attention_awareness_survey_9	I rush through activities without being really attentive to them.
eating_survey_12	I consciously hold back at meals in order not to weight gain.
five_facet_mindfulness_survey_27	I notice the smells and aromas of things. 
bis11_survey_21	I am a steady thinker.
upps_impulsivity_survey_14	I like sports and games in which you have to choose your next move very quickly.
time_perspective_survey_32	Taking risks keeps my life from becoming boring.
upps_impulsivity_survey_28	I finish what I start.
impulsive_venture_survey_12	Do you welcome new and exciting experiences and sensations even if they are a little frightening and unconventional?
time_perspective_survey_10	If things don't get done on time, I don't worry about it.
dospert_rt_survey_23	Speaking your mind about an unpopular issue in a meeting at work.
self_regulation_survey_29	If I wanted to change, I am confident that I could do it.
bis_bas_survey_18	I often wonder why people act the way they do.
dospert_rp_survey_13	Investing 5% of your annual income in a very speculative stock.
time_perspective_survey_25	I take each day as it is rather than try to plan it out.
upps_impulsivity_survey_8	I have trouble resisting my cravings (for food, cigarettes, etc.).
dospert_rt_survey_27	Walking home alone at night in an unsafe area of town.
dospert_rt_survey_18	Driving a car without wearing a seat belt.
upps_impulsivity_survey_43	I almost always finish projects that I start. 
time_perspective_survey_20	Ideally, I would live each day as if it were my last.
erq_survey_3	I keep my emotions to myself.
dospert_rp_survey_2	Admitting that your tastes are different from those of a friend.
grit_scale_survey_8	I finish whatever I begin.
time_perspective_survey_35	It's hard for me to forget unpleasant images of my youth.
bis11_survey_7	I have 'racing' thoughts.
impulsive_venture_survey_25	Would you enjoy the sensation of skiing very fast down a high mountain slope?
dospert_rp_survey_21	Riding a motorcycle without a helmet.
grit_scale_survey_4	I have been obsessed with a certain idea or project for a short time but later lost interest.
future_time_perspective_survey_8	There is plenty of time left in my life to make new plans.
five_facet_mindfulness_survey_14	I am easily distracted. 
theories_of_willpower_survey_13	Your capacity to resist temptations is not limited. Even after you have resisted a strong temptation you can control yourself right afterwards.
ten_item_personality_survey_5	Dependable, self-disciplined.
upps_impulsivity_survey_18	When I feel bad, I will often do things I later regret in order to make myself feel better now.
eating_survey_9	I get so hungry that my stomach often seems like a bottomless pit.
upps_impulsivity_survey_4	I generally seek new and exciting experiences and sensations.
eating_survey_16	How frequently do you avoid 'stocking up' on tempting foods?
mpq_control_survey_18	I know how to proceed.
upps_impulsivity_survey_11	When I am in great mood, I tend to get into situations that could cause me problems.
mpq_control_survey_16	I keep close track of money.
dospert_rt_survey_22	Choosing a career that you truly enjoy over a more secure one.
time_perspective_survey_4	Fate determines much in my life.
erq_survey_6	When I am faced with a stressful situation, I make myself <i>think about it</i> in a way that helps me stay calm.
impulsive_venture_survey_8	Do you often get into a jam because you do things without thinking?
five_facet_mindfulness_survey_6	When I do things, my mind wanders off and Im easily distracted. 
dospert_eb_survey_31	Not returning a wallet you found that contains $200.
bis_bas_survey_19	When good things happen to me, it affects me strongly.
time_perspective_survey_21	Happy memories of good times spring readily to mind.
bis11_survey_17	I change jobs.
self_regulation_survey_12	I give up quickly.
mindful_attention_awareness_survey_5	I tend to walk quickly to get where Im going without paying attention to what I experience along the way.
upps_impulsivity_survey_48	Sometimes there are so many little things to be done that I just ignore them all.
self_regulation_survey_7	I usually only have to make a mistake one time in order to learn from it.
mpq_control_survey_8	I buy something without thinking.
mpq_control_survey_17	I play things by ear.
bis_bas_survey_25	I worry about making mistakes.
ten_item_personality_survey_12	Conventional, uncreative.
mpq_control_survey_19	I am very level-headed.
eating_survey_5	Sometimes when I start eating, I just cant seem to stop.
time_perspective_survey_26	The past has too many unpleasant memories that I prefer not to think about.
upps_impulsivity_survey_47	I would enjoy the sensation of skiing very fast down a high mountain slope.
self_regulation_survey_15	I have personal standards, and try to live up to them.
time_perspective_survey_41	I complete projects on time by making steady progress.
grit_scale_survey_2	New ideas and projects sometimes distract me from previous ones.
upps_impulsivity_survey_51	In the heat of an argument, I will often say things that I later regret.
mpq_control_survey_15	I do the first thing that comes to mind.
upps_impulsivity_survey_26	When I am really ecstatic, I tend to get out of control.
dickman_survey_14	I frequently buy things without thinking about whether or not I can really afford them.
dospert_rt_survey_30	Leaving your young children alone at home while running an errand.
dospert_rp_survey_5	Investing 10% of your annual income in a moderate growth diversified fund.
dickman_survey_10	I often say and do things without considering the consequences.
upps_impulsivity_survey_7	My thinking is usually careful and purposeful.
bis_bas_survey_16	I often act on the spur of the moment.
grit_scale_survey_7	I have difficulty maintaining my focus on projects that take more than a few months to complete.
bis11_survey_30	I like puzzles.
upps_impulsivity_survey_40	It is hard for me to resist acting on my feelings. 
time_perspective_survey_50	I like family rituals and traditions that are regularly repeated.
dospert_rt_survey_5	Investing 10% of your annual income in a moderate growth diversified fund.
upps_impulsivity_survey_35	When I feel rejected, I will often say things that I later regret. 
bis11_survey_12	I 'squirm' at plays or lectures.
dospert_rp_survey_26	Piloting a small plane.
dickman_survey_24	I rarely get involved in projects without first considering the potential problems.
upps_impulsivity_survey_17	I like to stop and think things over before I do them.
dospert_eb_survey_21	Riding a motorcycle without a helmet.
future_time_perspective_survey_5	Most of my life lies ahead of me.
dospert_eb_survey_28	Moving to a city far away from your extended family.
dickman_survey_16	I like to take part in really fast-paced conversations, where you don't have much time to think before you speak.
dospert_rt_survey_28	Moving to a city far away from your extended family.
impulsive_venture_survey_15	Do you often do things on the spur of the moment?
mpq_control_survey_3	I take time to consider all aspects.
mpq_control_survey_6	I am fast and careless.
dickman_survey_18	Many times the plans I make don't work out because I havent gone over them carefully enough in advance.
dickman_survey_2	Often, I don't spend enough time thinking over a situation before I act.
self_regulation_survey_30	I can stick to a plan that's working well.
time_perspective_survey_22	I meet my obligations to friends and authorities on time.
self_regulation_survey_13	I usually keep track of my progress toward my goals.
dospert_rt_survey_12	Going down a ski run that is beyond your ability.
dickman_survey_17	I like sports and games in which you have to choose your next move very quickly.
theories_of_willpower_survey_6	When you have completed a strenuous mental activity, you cannot start another activity immediately with the same concentration because you have to recover your mental energy again.
future_time_perspective_survey_11	As I get older, I begin to experience time as limited.
mpq_control_survey_24	I have a good idea of what I'm going to do.
upps_impulsivity_survey_44	Before I get into a new situation I like to find out what to expect from it. 
future_time_perspective_survey_2	Many opportunities await me in the future.
time_perspective_survey_28	I've made mistakes in the past that I wish I could undo.
upps_impulsivity_survey_46	When overjoyed, I feel like I cant stop myself from going overboard.
time_perspective_survey_38	You can't really plan for the future because things change so much.
time_perspective_survey_42	I find myself tuning out when family members talk about the way things used to be.
eating_survey_6	Being with someone who is eating often makes me hungry enough to eat also.
five_facet_mindfulness_survey_32	I notice visual elements in art or nature, such as colors, shapes, textures, or patterns of light and shadow. 
upps_impulsivity_survey_12	I am not one of those people who blurt out things without thinking.
dospert_rt_survey_9	Betting a day's income at a high-stake poker game.
dickman_survey_13	I don't like to do things quickly, even when I am doing something that is not very difficult.
impulsive_venture_survey_28	Would you enjoy fast driving?
dospert_eb_survey_15	Betting a day's income on the outcome of a sporting event.
dospert_rt_survey_20	Taking a skydiving class.
eating_survey_3	I deliberately take small helpings as a means of controlling my weight.
upps_impulsivity_survey_23	Sometimes when I feel bad, I can't seem to stop what I am doing even though it is making me feel worse.
bis_bas_survey_11	I will often do things for no other reason than that they might be fun.
upps_impulsivity_survey_59	Sometimes I do impulsive things that I later regret.
time_perspective_survey_30	I get nostalgic about my childhood.
dospert_eb_survey_12	Going down a ski run that is beyond your ability.
five_facet_mindfulness_survey_40	I disapprove of myself when I have irrational ideas. 
future_time_perspective_survey_3	I expect that I will set many new goals in the future.
dospert_eb_survey_29	Starting a new career in your mid-thirties.
brief_self_control_survey_8	I wish I had more self-discipline.
eating_survey_11	When I feel lonely, I console myself by eating.
erq_survey_4	When I want to feel less <i>negative</i> emotion (such as sadness or anger), I <i>change what I am thinking about.</i>
impulsive_venture_survey_3	Usually do you prefer to stick to brands you know are reliable to trying new ones on the chance of finding something better?
dospert_rt_survey_3	Going camping in the wilderness.
dospert_rp_survey_4	Betting a day's income at the horse races.
time_perspective_survey_11	When I want to achieve something, I set goals and consider specific means for reaching those goals.
impulsive_venture_survey_4	Do you quite enjoy taking risks?
time_perspective_survey_56	I like my close relationships to be passionate.
upps_impulsivity_survey_29	I tend to value and follow a rational, 'sensible' approach to things.
five_facet_mindfulness_survey_33	My natural tendency is to put my experiences into words. 
erq_survey_2	When I want to feel more <i>positive</i> emotion (such as joy or amusement), I <i>change what I am thinking about.</i>
time_perspective_survey_49	I prefer friends who are spontaneous rather than predictable.
impulsive_venture_survey_31	Before making up your mind, do you consider all the advantages and disadvantages?
self_regulation_survey_14	I am able to accomplish goals for myself.
self_regulation_survey_4	It's hard for me to notice when I've 'had enough' (alcohol, food, sweets).
bis11_survey_28	I am more interested in the present than the future.
eating_survey_17	How likely are you to consciously eat less than you want?
brief_self_control_survey_4	I am lazy.
dospert_rt_survey_16	Engaging in unprotected sex.
self_regulation_survey_20	I set goals for myself and keep track of my progress.
time_perspective_survey_47	I find myself getting swept up in the excitement of the moment.
five_facet_mindfulness_survey_22	In difficult situations, I can pause without immediately reacting. 
time_perspective_survey_8	It gives me pleasure to think about my past.
theories_of_willpower_survey_8	Resisting temptations makes you feel more vulnerable to the next temptations that come along.
impulsive_venture_survey_34	When people shout at you, do you shout back?
dospert_rt_survey_11	Passing off somebody elses work as your own.
mindful_attention_awareness_survey_8	It seems I am 'running on automatic' without much awareness of what Im doing.
brief_self_control_survey_10	Pleasure and fun sometimes keep me from getting work done.
five_facet_mindfulness_survey_30	When I have distressing thoughts or images I am able just to notice them without reacting. 
five_facet_mindfulness_survey_18	I make judgments about whether my thoughts are good or bad. 
self_regulation_survey_21	If I make a resolution to change something, I pay a lot of attention to how I'm doing.
eating_survey_14	I am always hungry enough to eat at any time.
dospert_eb_survey_11	Passing off somebody elses work as your own.
self_regulation_survey_26	Most of the time I don't pay attention to what I'm doing.
impulsive_venture_survey_35	Do you usually make up your mind quickly?
dospert_eb_survey_22	Choosing a career that you truly enjoy over a more secure one.
mpq_control_survey_23	I do not have detailed plans.
upps_impulsivity_survey_19	I would enjoy water skiing.
upps_impulsivity_survey_57	I would enjoy fast driving.
dospert_eb_survey_24	Sunbathing without sunscreen.
time_perspective_survey_14	Meeting tomorrow's deadlines and doing other necessary work comes before tonight's play.
eating_survey_8	When I see a real delicacy, I often get so hungry that I have to eat right away.
theories_of_willpower_survey_7	After a strenuous mental activity, you feel energized for further challenging activities.
dospert_rp_survey_11	Passing off somebody elses work as your own.
ten_item_personality_survey_11	Calm, emotionally stable.
five_facet_mindfulness_survey_17	I have trouble thinking of the right words to express how I feel about things.
dospert_eb_survey_23	Speaking your mind about an unpopular issue in a meeting at work.
dospert_eb_survey_3	Going camping in the wilderness.
self_regulation_survey_16	As soon as I see a problem or challenge, I start looking for possible solutions.
theories_of_willpower_survey_5	Your mental stamina fuels itself. Even after strenuous mental exertion, you can continue doing more of it.
brief_self_control_survey_11	I have trouble concentrating.
mindful_attention_awareness_survey_6	I tend not to notice feelings of physical tension or discomfort until they really grab my attention.
bis_bas_survey_22	When I go after something I use a 'no holds barred' approach.
brief_self_control_survey_9	People would say that I have iron self-discipline.
impulsive_venture_survey_27	Would you like to go scuba diving?
erq_survey_7	I control my emotions by not expressing them.
five_facet_mindfulness_survey_25	When I have distressing thoughts or images, I feel calm soon after.
mpq_control_survey_2	I stop one activity before completing it.
upps_impulsivity_survey_54	I always keep my feelings under control.
bis11_survey_4	I make-up my mind quickly.
eating_survey_15	How often do you feel hungry?
upps_impulsivity_survey_41	When I get really happy about something, I tend to do things that can have bad consequences. 
five_facet_mindfulness_survey_20	When I have distressing thoughts or images, I step back and am aware of the thought or image without getting taken over by it. 
mindful_attention_awareness_survey_11	I do jobs or tasks automatically, without being aware of what Im doing.
upps_impulsivity_survey_27	I would enjoy parachute jumping.
brief_self_control_survey_5	I say inappropriate things.
time_perspective_survey_17	Painful past experiences keep being replayed in my mind.
upps_impulsivity_survey_36	Others are shocked or worried about the things I do when I am feeling very excited. 
dospert_rt_survey_17	Revealing a friend's secret to someone else.
impulsive_venture_survey_33	Do you prefer to 'sleep on it' before making decisions?
bis_bas_survey_17	If I think something unpleasant is going to happen I usually get pretty 'worked up.
dospert_rt_survey_10	Having an affair with a married man/woman.
impulsive_venture_survey_23	Generally do you prefer to enter cold sea water gradually, to diving or jumping straight in?
bis_bas_survey_6	I am always willing to try something new if I think it will be fun.
dickman_survey_22	I will often say whatever comes into my head without thinking first.
bis11_survey_26	I spend or charge more than I earn.
bis_bas_survey_14	I feel pretty worried or upset when I think or know somebody is angry at me.
bis_bas_survey_8	When I get something I want, I feel excited and energized.
bis11_survey_23	I buy things on impulse.
dospert_rp_survey_25	Bungee jumping off a tall bridge.
self_regulation_survey_22	I know how I want to be.
time_perspective_survey_15	Since whatever will be will be, it doesn't really matter what I do.
impulsive_venture_survey_20	Do you sometimes like doing things that are a bit frightening?
time_perspective_survey_46	I am able to resist temptations when I know that there is work to be done.
five_facet_mindfulness_survey_26	I tell myself that I shouldnt be thinking the way Im thinking. 
mindful_attention_awareness_survey_10	I get so focused on the goal I want to achieve that I lose touch with what I am doing right now to get there.
time_perspective_survey_57	There will always be time to catch up on my work.
future_time_perspective_survey_10	There are only limited possibilities in my future.
upps_impulsivity_survey_60	I am surprised at the things I do while in a great mood.
dospert_rt_survey_7	Taking some questionable deductions on your income tax return.
bis11_survey_6	I don't pay attention.
time_perspective_survey_51	I think about the bad things that have happened to me in the past.
brief_self_control_survey_3	I have a hard time breaking bad habits.
dospert_rp_survey_27	Walking home alone at night in an unsafe area of town.
bis_bas_survey_3	Even if something bad is about to happen to me, I rarely experience fear or nervousness.
dospert_eb_survey_2	Admitting that your tastes are different from those of a friend.
five_facet_mindfulness_survey_5	I perceive my feelings and emotions without having to react to them. 
mindful_attention_awareness_survey_13	I drive places on 'automatic pilot' and then wonder why I went there.
dospert_rp_survey_20	Taking a skydiving class.
time_perspective_survey_54	Often luck pays off better than hard work.
eating_survey_19	On a scale of 1 to 8, where 1 means no restraint in eating (eating whatever you want whenever you want it) and 8 means total restraint (constantly limiting food intake and never 'giving in') what number would you give yourself?
impulsive_venture_survey_19	Do you find it hard to understand people who risk their necks climbing mountains?
bis_bas_survey_15	When I see an opportunity for something I like I get excited right away.
bis_bas_survey_2	A person's family is the most important thing in life.
upps_impulsivity_survey_53	I tend to act without thinking when I am really excited.
dospert_rp_survey_29	Starting a new career in your mid-thirties.
grit_scale_survey_9	I am diligent.
five_facet_mindfulness_survey_16	I pay attention to sensations, such as the wind in my hair or sun on my face. 
mpq_control_survey_14	I am a spontaneous person.
brief_self_control_survey_14	I often act without thinking through all the alternatives.
grit_scale_survey_5	I am a hard worker.
upps_impulsivity_survey_58	When I am very happy, I feel like it is ok to give in to cravings or overindulge.
five_facet_mindfulness_survey_36	When I have distressing thoughts or images, I judge myself as good or bad, depending what the thought/image is about. 
time_perspective_survey_44	I make lists of things to do.
dospert_eb_survey_27	Walking home alone at night in an unsafe area of town.
ten_item_personality_survey_6	Anxious, easily upset.
bis_bas_survey_23	I have very few fears compared to my friends.
bis_bas_survey_12	It is hard for me to find the time to do things such as get a haircut.
bis_bas_survey_24	It would excite me to win a contest.
five_facet_mindfulness_survey_19	I find it difficult to stay focused on whats happening in the present. 
time_perspective_survey_7	I believe that a person's day should be planned ahead each morning.
self_regulation_survey_5	I have trouble following through with things once I've made up my mind to do something.
five_facet_mindfulness_survey_4	I criticize myself for having irrational or inappropriate emotions. 
dickman_survey_9	I have often missed out on opportunities because I couldn't make up my mind fast enough.
self_regulation_survey_10	I usually think before I act.
upps_impulsivity_survey_10	I tend to give up easily.
erq_survey_8	When I want to feel more <i>positive</i> emotion, I <i>change the way I am thinking</i> about the situation.
mindful_attention_awareness_survey_15	I find myself doing things without paying attention.
bis_bas_survey_10	When I want something I usually go all-out to get it.
leisure_time_activity_survey_2	During the past month, which statement best describes the kinds of physical activity you usually did? Do not include the time you spent working at a job. Please read all six statements before selecting one.
dickman_survey_19	I often get into trouble because I don't think before I act.
bis11_survey_24	I can only think about one thing at a time.
impulsive_venture_survey_30	Do you often change your interests?
impulsive_venture_survey_6	Do you often buy things on impulse?
dospert_rt_survey_15	Betting a day's income on the outcome of a sporting event.
dospert_rp_survey_8	Disagreeing with an authority figure on a major issue.
mindful_attention_awareness_survey_16	I snack without being aware that I'm eating.
self_regulation_survey_8	I can usually find several different possibilities when I want to change something.
bis11_survey_10	I concentrate easily.
dospert_eb_survey_5	Investing 10% of your annual income in a moderate growth diversified fund.
five_facet_mindfulness_survey_28	Even when Im feeling terribly upset, I can find a way to put it into words. 
self_regulation_survey_25	When it comes to deciding about a change, I feel overwhelmed by the choices.
five_facet_mindfulness_survey_29	I rush through activities without being really attentive to them. 
five_facet_mindfulness_survey_31	I think some of my emotions are bad or inappropriate and I shouldnt feel them. 
eating_survey_18	Do you go on eating binges though you are not hungry?
bis11_survey_25	I change hobbies.
upps_impulsivity_survey_37	I would like to learn to fly an airplane. 
impulsive_venture_survey_10	Do you like diving off the highboard?
mpq_control_survey_11	I am careful in reasoning.
time_perspective_survey_12	On balance, there is much more good to recall than bad in my past.
dospert_rp_survey_18	Driving a car without wearing a seat belt.
dickman_survey_8	I often make up my mind without taking the time to consider the situation from all angles.
erq_survey_10	When I am feeling <i>negative</i> emotions, I make sure not to express them.
time_perspective_survey_5	I often think of what I should have done differently in my life.
theories_of_willpower_survey_9	When situations accumulate that challenge you with temptations, it gets more and more difficult to resist the temptations.
upps_impulsivity_survey_55	When I am really happy, I often find myself in situations that I normally wouldn't be comfortable with.
five_facet_mindfulness_survey_34	When I have distressing thoughts or images, I just notice them and let them go. 
eating_survey_2	When I smell a sizzling steak or juicy piece of meat, I find it very difficult to keep from eating, even if I have just finished a meal.
five_facet_mindfulness_survey_8	I can easily put my beliefs, opinions, and expectations into words. 
brief_self_control_survey_2	I am good at resisting temptation.
time_perspective_survey_40	It doesn't make sense to worry about the future, since there is nothing that I can do about it anyway.
bis11_survey_15	I say things without thinking.
bis11_survey_19	I get easily bored when solving thought problems.
mindful_attention_awareness_survey_7	I forget a person's name almost as soon as I've been told it for the first time.
time_perspective_survey_27	It is important to put excitement in my life.
dospert_rp_survey_12	Going down a ski run that is beyond your ability.
grit_scale_survey_3	Setbacks don't discourage me.
eating_survey_10	I am always hungry so it is hard for me to stop eating before I finish the food on my plate.
upps_impulsivity_survey_39	I am a cautious person. 
self_regulation_survey_31	I have a lot of willpower.
impulsive_venture_survey_32	Would you be put off a job involving quite a bit of danger?
self_regulation_survey_23	I have trouble making up my mind about things.
bis11_survey_16	I like to think about complex problems.
dospert_eb_survey_14	Going whitewater rafting at high water in the spring.
upps_impulsivity_survey_33	I am able to pace myself so as to get things done on time.
time_perspective_survey_48	Life today is too complicated; I would prefer the simpler life of the past.
dospert_eb_survey_13	Investing 5% of your annual income in a very speculative stock.
time_perspective_survey_13	When listening to my favorite music, I often lose all track of time.
brief_self_control_survey_13	Sometimes I can't stop myself from doing something, even if I know it is wrong.
upps_impulsivity_survey_2	I have a reserved and cautious attitude toward life.
five_facet_mindfulness_survey_21	I pay attention to sounds, such as clocks ticking, birds chirping, or cars passing. 
mpq_control_survey_22	I am methodical.
five_facet_mindfulness_survey_37	I pay attention to how my emotions affect my thoughts and behavior. 
time_perspective_survey_23	I've taken my share of abuse and rejection in the past.
upps_impulsivity_survey_13	I often get involved in things I later wish I could get out of.
five_facet_mindfulness_survey_9	I dont pay attention to what Im doing because Im daydreaming, worrying, or otherwise distracted. 
dospert_eb_survey_7	Taking some questionable deductions on your income tax return.
brief_self_control_survey_6	I do certain things that are bad for me, if they are fun.
dospert_rt_survey_24	Sunbathing without sunscreen.
dospert_eb_survey_19	Investing 10% of your annual income in a new business venture.
self_regulation_survey_2	I don't notice the effects of my actions until it's too late.
ten_item_personality_survey_4	Critical, quarrelsome. 
dickman_survey_3	I try to avoid activities where you have to act without much time to think first.
bis11_survey_22	I change residences.
dospert_rt_survey_2	Admitting that your tastes are different from those of a friend.
dospert_rp_survey_3	Going camping in the wilderness.
dospert_rt_survey_8	Disagreeing with an authority figure on a major issue.
self_regulation_survey_6	I don't seem to learn from my mistakes.
five_facet_mindfulness_survey_12	I notice how foods and drinks affect my thoughts, bodily sensations, and emotions. 
upps_impulsivity_survey_15	Unfinished tasks really bother me.
bis11_survey_31	I am future oriented.
dospert_eb_survey_6	Drinking heavily at a social function.
five_facet_mindfulness_survey_7	When I take a shower or bath, I stay alert to the sensations of water on my body. 
dospert_rp_survey_17	Revealing a friend's secret to someone else.
dickman_survey_20	Most of the time, I can put my thoughts into words very rapidly.
time_perspective_survey_18	I try to live my life as fully as possible, one day at a time.
self_regulation_survey_32	I am able to resist temptation.
dospert_rp_survey_15	Betting a day's income on the outcome of a sporting event.
mpq_control_survey_13	I am cautious person.
bis_bas_survey_9	Criticism or scolding hurts me quite a bit.
ten_item_personality_survey_9	Sympathetic, warm.
impulsive_venture_survey_16	Do you mostly speak before thinking things out?
dospert_rp_survey_10	Having an affair with a married man/woman.
dickman_survey_23	Before making any important decision, I carefully weigh the pros and cons.
upps_impulsivity_survey_25	I concentrate easily.
time_perspective_survey_39	My life path is controlled by forces I cannot influence.
dospert_rt_survey_14	Going whitewater rafting at high water in the spring.
upps_impulsivity_survey_52	I would like to go scuba diving.
dickman_survey_7	I would enjoy working at a job that required me to make a lot of split-second decisions.
upps_impulsivity_survey_30	When I am upset I often act without thinking.
dospert_rt_survey_4	Betting a day's income at the horse races.
bis11_survey_18	I act on impulse.
dospert_eb_survey_10	Having an affair with a married man/woman.
dospert_eb_survey_18	Driving a car without wearing a seat belt.
impulsive_venture_survey_18	Do you get so 'carried away' by new and exciting ideas. that you never think of possible snags?
dospert_eb_survey_17	Revealing a friend's secret to someone else.
mindful_attention_awareness_survey_3	I break or spill things because of carelessness, not paying attention, or thinking of something else.
bis11_survey_29	I am restless at the theater or lectures.
impulsive_venture_survey_26	Do you think an evening out is more successful if it is unplanned or arranged at the last moment?
bis_bas_survey_4	I go out of my way to get things I want.
bis_bas_survey_13	If I see a chance to get something I want I move on it right away.
impulsive_venture_survey_24	Are you often surprised at people's reactions to what you do or say?
theories_of_willpower_survey_2	Strenuous mental activity exhausts your resources, which you need to refuel afterwards (e.g. through taking breaks, doing nothing, watching television, eating snacks).
self_regulation_survey_18	When I'm trying to change something, I pay a lot of attention to how I'm doing.
brief_self_control_survey_12	I am able to work effectively toward long-term goals.
five_facet_mindfulness_survey_2	When Im walking, I deliberately notice the sensations of my body moving. 
upps_impulsivity_survey_45	I often make matters worse because I act without thinking when I am upset.
five_facet_mindfulness_survey_39	I find myself doing things without paying attention. 
dickman_survey_12	I am uncomfortable when l have to make up my mind rapidly.
bis_bas_survey_7	How I dress is important to me.
erq_survey_5	When I am feeling <i>positive</i> emotions, I am careful not to express them.
ten_item_personality_survey_3	Extraverted, enthusiastic.
dickman_survey_11	I frequently make appointments without thinking about whether I will be able to keep them.
five_facet_mindfulness_survey_24	It seems I am running on automatic without much awareness of what Im doing. 
impulsive_venture_survey_9	Do you think hitch-hiking is too dangerous a way to travel?
mpq_control_survey_21	I often start projects.
bis_bas_survey_5	When I am doing well at something I love to keep at it.
bis11_survey_3	I do things without thinking.
bis11_survey_5	I am happy-go-lucky.
dospert_rp_survey_28	Moving to a city far away from your extended family.
grit_scale_survey_6	I often set a goal but later choose to pursue a different one.
dospert_eb_survey_25	Bungee jumping off a tall bridge.
dospert_rt_survey_13	Investing 5% of your annual income in a very speculative stock.
dospert_eb_survey_16	Engaging in unprotected sex.
dospert_rp_survey_16	Engaging in unprotected sex.
dickman_survey_15	I am good at careful reasoning.
MeasurementToolMetadata	Future time perspective survey
upps_impulsivity_survey_42	I sometimes like doing things that are a bit frightening. 
upps_impulsivity_survey_34	I usually make up my mind through careful reasoning.
bis11_survey_27	I often have extraneous thoughts when thinking.
bis_bas_survey_21	I crave excitement and new sensations.
dospert_eb_survey_9	Betting a day's income at a high-stake poker game.
theories_of_willpower_survey_3	After a strenuous mental activity, your energy is depleted and you must rest to get it refuelled again.
time_perspective_survey_45	I often follow my heart more than my head.
impulsive_venture_survey_7	Do you generally do and say things without stopping to think?
dospert_eb_survey_4	Betting a day's income at the horse races.
time_perspective_survey_31	Before making a decision, I weigh the costs against the benefits.
dickman_survey_4	I don't like to make decisions quickly, even simple decisions, such as choosing what to wear, or what to have for dinner.
self_regulation_survey_11	I learn from my mistakes.
five_facet_mindfulness_survey_3	Im good at finding words to describe my feelings. 
mindful_attention_awareness_survey_12	I find myself listening to someone with one ear, doing something else at the same time.
time_perspective_survey_24	I make decisions on the spur of the moment.
upps_impulsivity_survey_50	When I am really excited, I tend not to think of the consequences of my actions.
five_facet_mindfulness_survey_35	I do jobs or tasks automatically without being aware of what Im doing. 
bis11_survey_11	I save regularly.
dospert_rt_survey_26	Piloting a small plane.
bis11_survey_8	I plan trips well ahead of time.
self_regulation_survey_27	I tend to keep doing the same thing, even when it doesn't work.
upps_impulsivity_survey_32	I welcome new and exciting experiences and sensations, even if they are a little frightening and unconventional.
impulsive_venture_survey_17	Do you often get involved in things you later wish you could get out of?
dospert_rt_survey_19	Investing 10% of your annual income in a new business venture.
impulsive_venture_survey_22	Would you agree that almost everything enjoyable is illegal or immoral?
upps_impulsivity_survey_31	Others would say I make bad choices when I am extremely happy about something.
upps_impulsivity_survey_24	I quite enjoy taking risks.
time_perspective_survey_16	I enjoy stories about how things used to be in the 'good old times.'
upps_impulsivity_survey_38	I am a person who always gets the job done. 
dospert_rt_survey_25	Bungee jumping off a tall bridge.
self_regulation_survey_3	I put off making decisions.
mpq_control_survey_7	I am never reckless.
mpq_control_survey_25	I like to find out what to expect.
mpq_control_survey_10	I do things on the spur of the moment.
brief_self_control_survey_7	I refuse things that are bad for me.
five_facet_mindfulness_survey_13	Its hard for me to find the words to describe what Im thinking. 
dospert_rt_survey_21	Riding a motorcycle without a helmet.
bis_bas_survey_20	I feel worried when I think I have done poorly at something important.
five_facet_mindfulness_survey_11	I tell myself I shouldnt be feeling the way Im feeling. 
self_regulation_survey_28	Once I have a goal, I can usually plan how to reach it.
dospert_eb_survey_20	Taking a skydiving class.
time_perspective_survey_19	It upsets me to be late for appointments.
erq_survey_9	I control my emotions by <i>changing the way</i> I think about the situation I am in.
five_facet_mindfulness_survey_38	I can usually describe how I feel at the moment in considerable detail. 
eating_survey_7	When I feel blue, I often overeat.
self_regulation_survey_9	Often I don't notice what I'm doing until someone calls it to my attention.
impulsive_venture_survey_21	Do you need to use a lot of self-control to keep out of trouble?
impulsive_venture_survey_5	Would you enjoy parachute jumping?
dospert_eb_survey_8	Disagreeing with an authority figure on a major issue.
dospert_eb_survey_26	Piloting a small plane.
time_perspective_survey_2	I believe that getting together with one's friends to party is one of life's important pleasures.
upps_impulsivity_survey_49	I usually think carefully before doing anything.
future_time_perspective_survey_9	I have the sense that time is running out.
dickman_survey_5	I enjoy working out problems slowly and carefully.
time_perspective_survey_52	I keep working at difficult, uninteresting tasks if they will help me get ahead.
upps_impulsivity_survey_21	I tend to lose control when I am in a great mood.
five_facet_mindfulness_survey_23	When I have a sensation in my body, its difficult for me to describe it because I cant find the right words. 
theories_of_willpower_survey_4	When you have been working on a strenuous mental task, you feel energized and you are able to immediately start with another demanding activity.
theories_of_willpower_survey_11	It is particularly difficult to resist a temptation after resisting another temptation right before.
erq_survey_11	When I want to feel less <i>negative</i> emotion, I <i>change the way I am thinking</i> about the situation.
dickman_survey_21	People have admired me because I can think quickly.
upps_impulsivity_survey_16	When I am very happy, I tend to do things that may cause problems in my life.
dospert_rt_survey_31	Not returning a wallet you found that contains $200.
bis11_survey_2	I plan tasks carefully.
upps_impulsivity_survey_9	I'll try anything once.
ten_item_personality_survey_8	Reserved, quiet.
upps_impulsivity_survey_6	When I am very happy, I cant seem to stop myself from doing things that can have bad consequences.
eating_survey_4	When I feel anxious, I find myself eating.
time_perspective_survey_43	I take risks to put excitement in my life.
upps_impulsivity_survey_3	I have trouble controlling my impulses.
five_facet_mindfulness_survey_10	I watch my feelings without getting lost in them. 
time_perspective_survey_34	Things rarely work out as I expected.
impulsive_venture_survey_11	Are you an impulsive person?
mindful_attention_awareness_survey_14	I find myself preoccupied with the future or the past.
five_facet_mindfulness_survey_15	I believe some of my thoughts are abnormal or bad and I shouldnt think that way.
dospert_rp_survey_31	Not returning a wallet you found that contains $200.
time_perspective_survey_55	I think about the good things that I have missed out on in my life.
impulsive_venture_survey_2	Would you enjoy water skiing?
time_perspective_survey_6	My decisions are mostly influenced by people and things around me.
dospert_rp_survey_9	Betting a day's income at a high-stake poker game.
bis11_survey_14	I plan for job security.
dospert_rp_survey_30	Leaving your young children alone at home while running an errand.
self_regulation_survey_17	I have a hard time setting goals for myself.
ten_item_personality_survey_10	Disorganized, careless.
